@..@@.@..@@@.@@@@@@.@@@@@@@@.@@@.@@@.@.@@@.@....@@@.@...@@.@..@@@@@.@@@.@@...@@.@@@.@@@@.@@@@.@.@@@@..@@@@@@.@.@.@.@@@@.@@.@@.@@@@..@.@.@@@
.@..@@@@@@@.@@@@.@@@@..@@.@.@..@@@.@@@@@@...@@.@@.@...@@@..@.@@@@......@@@@@@@.@@.@.@@@@..@....@.@..@@.@.@@@.@.@@@.@@@@.@@.@.@@..@@@@.@@.@@
@@@..@@@@@@@@@@@.@..@.@@@@@@@@@....@.@.@@@@@.@....@@@@@@.@@@@@@@@@@@@@.@.@@...@@@@@..@@@@@.@..@@@@.@@@@.@@@@@@@@.@@@@@@@@@@@@@@@@.@@@@@@@.@
@@@@@@@.@@@.@.@@@.........@.@@@.@@@@@@.@.@@@@@@@@..@@@.@@@@@@.@.@.@.@.@@@@@@@@.@@@@@@.@...@@@.@@.@@.@@@@@@@.@@.@.@.@@@@.@.@@@.@@@.@@.@.@@@.
..@@..@@@.@@@@@@@.@.@.@@.@@..@@...@@@@@.@@@@@.@@.@@@.@@.@@@@@.@@.......@@..@@..@.@@.@@.@@@.@.@@@@.@..@@@.@@@@@.@@....@@@@@@.@@@@.@@.@@@.@.@
@@@@@@......@@@..@@.@@.@...@.@.@@@@.@.@.@...@@@@.@.@@@@@@@@@@@@...@....@@..@@.@@@@@@@@@..@@..@@@.@@@@@@@@@.@@@.@@@@@.@@@.@@@.@@@@@.@.@.....
.@@@@.@...@@@....@@...@@@@@@@@.@@....@.@.@.@@@@@@@@@@@.@@.....@@@@@@@@@@@.@.@@@@@@@@@@@@.@@@.@@@@@.@@@@@@@..@.@@....@@@..@@.@.@.@.@.@.@@@@.
@@.@@.@@@.@@@@.@..@...@.@@@.@.@@@@..@..@.@@@.@@@@.@...@@@@@@.@.@@@...@@.@@@@@@@@@..@.@@@..@@@@@@@@@@.@@@.@@@@@@...@.@@.@@@.@@...@@@.@.@.@@@
....@.@..@@@@@.@@@@@@@@@@..@@..@@@@.@@.@.@.@@.@@@.@@.@@@@@@.@@@@@.@@.@@@@@..@@.@.@@@..@@@@.@@@@.@@@@..@@@@@@@@..@..@.@.@.@@@.@.@@@@..@@@@.@
@@@.@@@@.@.@@@.@..@.@.@@..@@@.@.@.@@@@@@.@..@.@@.@...@@.@.@@...@@@...@@@.@@@@@..@.@@@.@@@@@@@@..@@@@@@@@.@@@@.@@@@@..@@.@@..@@.@@@@..@.@@.@
@@@@.@@@.@..@@@@.@@....@....@@@@@@@@@@@@.@@@.@@@@@.@@.@..@@..@.@..@..@@..@@@@@..@@.@@@@@@@@@@@..@@@@@.@.@@@@@@@@@@@..@@@@..@@@.@@..@...@@@@
@.@@@@..@@@@@.@......@@@@@@.@@@..@@@@..@@.@@@.@@@@@@.@@..@@.@@@@@@@@@@@@..@.@@@...@@@..@@.@.@@@@.@.@@@@.@.@..@@@.@..@@.@.@@@@@@.@@@@.@.@..@
@@@@@.@..@@.@..@@@@@.@@..@@@@...@@.@.@.@.@..@..@@.@@@..@...@@..@@@.@.@@..@@.@@.@@.@@.@.@@.@@.@.@@.@.....@@.@@..@......@@@@@.@@.@@@@@@@.@.@@
@@@@..@@@@.@.@......@@.@.@.@@..@.@@@@@...@@..@@..@@@@@@.@@@.@@..@..@@.@@@.@@@@.@@@@@@.@.@@.....@.@@@.@@@......@@@...@@..@@@..@.@@@.@@@@.@@@
.@.@@@.@.@...@@@.@@.@@@@@@@...@@@@@...@@@.@@.@@@@..@@.@@..@@@..@@@.@@@@@@@@@..@...@@..@.@@@@@@@@@.@@@@..@.@@..@@.@@@.@.@@.@.@@@@@...@.@@.@@
@.@.@@..@@.@.@@@@..@@@@.@.@@@@@@@@@@@..@@.@@.@@..@@..@.@@@@@@@.@..@@@@@.@@@@@.@@@@@@@@@@@..@.@@@@@@.@@@.@@@@.@@@@@@.@@@.@..@...@@@.@@@.@@.@
@.@@@.@@...@.@@@@@..@@..@@@@@..@@@@@@..@...@@@@@@@@@@@@@@@.@..@.@@@@@@..@@@...@@.@@@@.@.@@.@.@..@@@....@.@@.@@@@@@..@.@.@..@@..@@@@@.@@@.@@
.@@@@@@@.@@@..@......@@@@@@@@@@..@.@@.@@.@@@.@@.@@@@@@@.@@@@@.@@.@..@@@@@@@@..@@.@.@..@.@@@.@@@@@@@.@.@@.@@@....@@.@...@.@@@.@@@...@@@@@...
@.@@@@@.@@@@...@@@@@.@.@@@@.@@..@.@@@.@.@..@@@..@@@..@@@.@@.@@@@@.@@@@@@@@@@.@.@@@@..@@@.@..@.@@.@..@@@.@@@.@@@@@@@@.@@@..@.@.@...@@...@@@@
@.@.@@.@..@..@@@@@.@@@@@@.@@@.@..@.@@.@.@@.@@.@.@@..@@@@@@@@@@.@@...@@.@@..@@@.@@@.@@@@...@@@@@@.@@.@@.@.@@@@@@.@.@@@@.@..@.@@@@@.@@.@@@.@@
@@@....@@.@@@@@@@@@.@@@@@@@@@@@@@@.@@@@@@@@..@.@..@@@....@.@@@.@@@.@.@.@@.@@.@@@...@@@@@@@.@@@@..@.@@@...@@@@..@..@@@.@@@..@@..@@@..@@.@@@@
..@.@..@@@@@@.@.@.@@.@@@@@@.@.@@..@@@@@@@@@@.@@@.@...@@@.....@@.@@.@.@.@@@@@@@.@..@.@@@@@@@.....@@..@@.@@@.@@@@...@.@.@@@.@@.@@@.@@.@@@..@@
@@@@.@....@@@@@@@@@@.@@...@@@@.@@.@@@@.@.@@@.@@@@..@@@.@@@.@..@.@@.@@@@.@.@@@@@.@..@@.@@@@@.@.@@..@....@@@@@@@@@@@@@@@..@@@@.@..@@@@@@@.@@.
.@@....@@@...@.@..@....@@.@@@@..@..@@@..@@@@.@@@..@@.@@@.@..@@@..@@@@@@@...@@@@...@.@@.@@@@.@.@@@@@.@...@@.@@@@@....@..@@@@@....@@@@@.@.@@@
@@.@@@.@@...@@.@.@..@@@..@@.@...@@@@..@@@.@..@....@@@..@@@.@@@@@@@@..@@@..@..@@.@@.@@@@....@@@..@..@@..@@@@.@.@.@@.@@@..@@.@..@@@@...@@@.@.
@.@.@@@@.@@@@@@@@..@@@@..@@..@@@.@@.@@@@@..@@@@@.@..@.@.@.@@@.@.@@.@.@.@@@.@@.@@@@@@@@..@@.@.@@@@@@@@@@.@@@@@@@.@@@@@.@@@@...@@@@@@@@..@@.@
@@@..@@@@.@.@@.@@..@..@.@@@@.@.@..@@..@.@.@@@@@@..@.....@..@@@@@@@@@.@@..@.@@.@.@@@@@.@@@@@@@@@......@@.@...@@@@@..@@@@@@@.@.@..@@.@@@@@@@@
@@..@@.@@@@@@@@.@@@@@.@@.@@..@@.@@.@@@@@@@@.@@.@.@@@...@@@@@@@@@.@@@.@@.@.@@.@@@@..@@@.@@@@@@@@...@@..@@@@@.@@@...@..@@..@@@..@.@@@@@@@.@..
@.@@..@@.@@..@...@.@@@@@.@.@..@.@@@@.@.@.@@@.@.@.@@@..@@@@@@@@@@.@...@@@...@@..@@@.@@@@..@@@.@@@@@@@@@@..@@.@.@@.@..@......@...@@@.@@@@.@.@
@@.@..@@.@.@@@.@....@@.@@@@@.@.@@@..@@@@.@@@.@....@.@@@..@@@@....@.@....@@.@.@@@@@@@@...@@@.@@@.@.@@@@..@@@@@@@@@..@@...@@@.@.@.@@@@.@.@@@@
@@@@.@@@@...@@@@.@@@.@@@@@@@@@..@@@@..@@@....@@.@.@@@..@@.@...@@...@@.@@@@.@.@@@@.@@@@.@.@@@@@@@.@.@@...@@@@.@@@.@@@@.@.@@@.@.@@..@@@.@...@
.@@.@@@@.@..@@@@@@@..@..@@@@@@.@..@...@@.@.@...@..@@@@@@.@@.@.@@@@@.@.@.@@..@.@@@@@@.@@..@@@.@@.@@@@@@.@@@@@@@@@@@@@@@@@@@@@.@@@@@.@...@@@.
@@..@..@..@@.@@@@@@@@@.@@@@@.@@@@.@@@@@@@..@..@@@.@@..@@.@...@@@@@..@@@@@.@..@@..@@@@@.@....@...@@@.@@@.@@@@@.@.@.@..@..@@@.@@@.@..@.@@@@@.
@@@..@@..@@@@@@@@.@@@..@@@@@@@@@@@@.@.@@.@.@@@@@..@.@@@@@.@@@@.@@@@@@@@@@@@..@@.@@@@..@@@.@@..@.@@@@.@@@@@@@@@@@@.@.@@.@..@.@.@@@..@.@.@@..
...@@@.@@@@...@@.@.@@@@.@@..@.@..@@@.@@@@@..@@@..@@@@..@.@.@@@@@.@.@@@@@@@@@@.@@@.@@@@@@@@@.@.@.@@@@.@@..@@......@@..@@@.@@.@@.@@@@@.@.@@@@
.@@@@...@....@@@...@@.@.@.@@@@@@@@@@.@.@..@@@@@@.@..@@@.@@@.@@.@@@@@@.@@...@.....@@@.@.@.@@@@@@..@@@@@@@@@.@@@.@...@..@@@@@.@@@...@@@.@@@.@
@@@@.@@@...@@@.@@@@.@@@@@@@@.@@@@@....@@@@@@@@@.@.@@@@@@.@..@@@.@.@@@..@@@@@..@@.@@@@...@@@@@@....@@@@@.@@@@@@@@.@.@@@@@@@.@.@@@.@@.@.@@..@
..@@..@@.@.@.@.....@.@@@@@@..@@@@.@@@@@.@@.@.@@@.@@@@@@@@.@@@@.@.@.@.@@@@@@@@@@...@@@@.@..@@@@@.@@.@@@.@@@@@@@@.@@@..@@@.@.....@.@..@@.@@.@
@.@@@.@@@@@@.@@@@@@@@.@.@@@@.@..@.@@...@..@.@@..@..@.@.@@@..@@.@.@.....@@....@@@..@@@.@@.@@@@@@..@.@@..@@@.@@@@@@@@.@@@@@@@@@@.@@..@@@@@@@.
.@@@@@.@.@.@...@@@.@.@@@@@.@@@.@@@..@.@...@@@@@@@.@@@@@@@@@.@@....@@@@@.@@@@..@@@@@@.@.@.@..@.@.@.@@.@@.@@@@.@@.@.@@.@.@@.@.@..@..@@.@@....
.@@@@@@....@.@@@@@@@@@@@@@@@..@@@@@.@.@.@.@@@@....@.@.@@.@@@@@@.@.@@@@@@@@..@..@@@..@@@.@@....@@@..@@@@...@@.@@@@@@.@.@@@@..@@@@@@.@...@.@@
@@@@@@@@.@@@@@.@..@@...@@@..@@.@@..@..@@@@.@.@..@@@@@@.@.@@.@@.@@@@@.@@..@..@@@@@.@@@.@@..@@@@@@..@@@.@.@@@@@@..@..@@@..@.@@.@@@.@.@@..@..@
@@.@@@@@.@@@@@@@@@@.@@.@..@@..@@@@...@@.@..@@....@@.@@.@.@@@..@.@@@@@@@@@@@@@@..@@@@@@@.@@.@@@@@..@.@@@@@@..@@@...@@@@@.@@@.@@.@.@...@@@@..
....@@@.@.@@@@@@@@@.@.@@.@...@@@@@@.@.@..@@.@...@@@@.@@@@.@@@.@.@@..@@@@@@.@@@@..@@@@@@@@@@.@.@.@@..@.@.@@.@@@.@@@@@@@..@@.@@@@@.@.@@@.@...
@@@@@@..@.@@@@@@@@@@@@@@..@@...@@@@@@@@@@@.@.@@@.@@@@@..@.@@..@..@@@@@.@@@@@.@@..@.@@@....@@@@.@@@@@@@..@.@@@@@@@@@@@@@@@.@@.@.@.@@@@.@@@@.
@...@@..@.@@@@.@@@..@.@@.@@.@@@.@@.@..@@@..@.@@@@@@.@@@..@@@.@@@@.@@.@.@@....@.@...@@@@@@@.@@@.@@@@.@@.@@.@@.@@@@.@....@@@@@@@@@..@.@@@@.@.
@@@..@@.@.@...@...@.@..@.@@@@.@@@.@.@@@...@@@@@@@...@.....@@@.@@@@@@@@@@@..@.@...@@.@@@@.@@.@@.@..@@@@.@@@@.@@@@@.@..@@@..@@@.@@...@@..@@@@
.@@@@@@@.@@@@.@@@@@.@@@.@@@@..@@@@@@@@@@@..@.@@@@..@@@@@@@@@..@@@.@@..@@@.@.@@@.@@@..@.@@@@@@@.@@@@@..@.@.@@@@@.@..@.@.@.@@....@@@@@@.@.@@@
@@@@.@@.@@.@@@.@@@.@@@@@@.@@@.@@@@@@.@@.@@..@@@@@@...@.@@@.@..@@@@...@..@.@@@@@.@.@.@@@@@@@@@@..@@@.@.@@@.@@@@....@.@@..@@.@@@@@@@@@..@@@.@
@.@.@@@@@.@@.@@@.@.@@@..@@.@@.@@@@@@@@..@@@@..@@...@.@.@@@....@.@..@@@@@@@@@@.@@....@.@@..@@@@@...@@@@@.@.@@@@..@@@.@..@@.@@.@.@@...@@@@@@@
@@.@@@@.@@@...@@@..@.@.@@@.@@@@@.@@@.@.@.@.@@...@@.@.@@@@.@..@@..@@.@@.@.@.@..@..@@@@.@.@@@@@.@.@..@@@@@@@.@@.@@@....@.@..@@..@@...@@@.@.@@
@@.@@.@@@@@@.@@.@..@..@...@@@.@@..@.@@@..@@.@.@.@@.@@@..@@@.@@..@@@@@@@..@.@@.@.@@@@.@.@.@@.@@@.@@@.@@.@@@@.@@@@@...@@@@@@@@@.@@@@@.@@..@..
@.@@@.@@@@@@@.@.@.@@@@@.@@@@@.@@@@@@@.@@.@.@.@@@@@@@@@@@...@..@@.@@.@@@@.@@@.@@@@...@@@@@@.@@@@@@@.@@@.@@@@@....@..@@@.@@..@.@@..@..@@.@@@@
@.@@@@@..@@@..@@@@...@@@.@@@...@@.@@..@..@@..@@.@@@..@@@@@@.@@@.@@...@.@.@..@.@@@@.@@..@.@@@@.@@.@@@@@.@@@@.@.@@.@.@@@@.@@.@.@..@...@@@@.@.
@@@..@.@.@......@..@...@...@.@@@@@@@@.@@.@@@.@@@.@..@.@@.@.@@.@.@@@.@.@@..@.@.@.@.@.@.@.@@@@@@@@.@.@@@@@@@@@@@@@@.@@@@@@@@..@@..@..@@@@@@.@
@@@@.@..@.@.....@@.@@.@@.@@..@@@@...@.@@@@@@.@@..@@@.@....@.@@.@....@....@@@.@@@@@@@..@@.@@..@.@@@.@@@@@.@.@@@@@.@.@@@@...@.@@@@@@@@@@@.@@@
.@.@..@.@@.@@@@@.@@@..@@@.@.@@@..@@@@@@@.@@@.@@.@@@..@@@@@.@.@.@@.@.@@@@.@..@@@.@@@...@@@@.@@@..@@.@....@.@@@@@..@@....@..@@@.@.@@.@.@.@@.@
..@.@@@@@@.@@@.@@@.@@@@@@@@@@@@@@@...@@.....@@@@@@@.@..@@@@@@@@....@@@@..@@.@@@@@.@@.@.@@@@@.@.@@@@.@@@@@@...@@@.@.@.@.@@@@.@@@.@..@.@@...@
@.@.@.@@.@@@@.@@@@@.@.@...@@@@..@@@@@...@..@@@@@@..@@.@@.@@@@...@@@@.@@@...@@.@@..@@.@.@@@@@@@@...@@@@@..@@.@.@@@.@@@..@@...@@@@@@@@@@.@@.@
@@..@@.@.@@@@@@@.@@@@..@.@@.......@@..@@@@@.@@@@..@@@@..@.@.@.@@.@@@.@@@@@.@@@.@@@@@@@.@@@@@@@@.@@@@.@@.@.@@...@..@@@@.@.@@@@.@@..@@@..@@@@
@@.....@.@.@@@@@.@@..@@@.@@@@.@..@@@@@...@@@.@.@@@.@.@@@@@@.@.@..@.@.@@.@.@@@@@@@@.@.@@@.@..@@.@.@..@.@@@@..@@@@@@@@..@@@@@...@@@@@.@@.@@@.
@@@@@@@@....@@@.@.@@.@@.@..@@@@@@......@@@.@.@.@..@@..@@@@@@@@@..@..@.@@.@@@@.@@@.@@..@@@@@@....@@.@....@@@@.@@@@.@@@@..@@@@@@@@@@@@@@@@..@
@@..@@@..@.@@@.@..@@@@.@.@..@@.@..@..@@.@@@@@...@@..@.@@@@@@@...@@.@@@.@@@@@@@.@@@.@@..@.@@..@.@.@...@.....@@@@@.@.@@.@.@@@.@..@@@@@@..@@@@
.@.@@@@.@....@@.@@......@@@@@@@..@@@@@@@.@.@...@@@@@@@@@@@.@..@@..@@..@@@@@.@@@..@@.@@@@@.@@.@@@.@@....@..@@@@@@@@..@.@@@..@@@@..@.@.....@@
.@.@..@@.@.@@@@@@.@@@@@...@@...@@.@@.@@@@@@@@@@...@.@.@.@@...@.@@..@.@@@@@@@@.@@@@@@@...@@...@@@@@@@@@@@@@...@@.@@@...@@@.@@@@@@@.@@.@@..@@
..@@.@@.@...@@@....@@....@@.@@@.@@..@..@@..@@@@.@.@@@@@.@@@@...@@@@@@@@@@.@.@...@.@@@@@.@@@@.@@@@@.@@@@@@.@@.@@@.@@@.@@@@@@..@@@@@@@@.@@@@.
@@@.@@@@@@@@..@..@@@.@@@.@@@.@@.@@..@..@.@..@....@@@@@..@@@..@.@@@@@@.@@.@@.@@@@...@.@@@@@.@.@@@@.@@@@@@@@@@.@@.@@@@@@@@.@@@@@@@@@.@@@..@.@
@@@.@.@@.@@....@@@@@..@.@@@...@.@....@@@@@.@.@@@@@@@@@...@@...@.@@@@@..@..@@@.@@@.@@...@.@.@@@....@.@..@@...@...@@.@@@@..@.@@@@@@@.@..@@@..
.@@@.@......@.@..@.@@....@.@@@.@@.@....@@..@.@@@.@@@@...@@.@@@@@.@@@..@@@@@@..@@.@.@@@.@...@@@@@.@..@@@@@@..@@..@.@@@.@..@@.@@.@@.@@.@.@@@@
@@.@@@@@@..@@.@.@@@@@.@@@@@@@.@.@..@@@@@.@@@...@.@@@@@@@@..@@@.@@@@@@.@..@@@@@..@....@...@@@.@@.@.@@@@@@@@.@@@@@.@..@@.@@@@.@@@@.@@..@.@..@
@.@..@@.@@@@.@.@@@@.@@@@@@@@.@@@@@.@@@@@@@@@@@.@@@@@@@.@@@@@@...@.@@@@.@@@@@...@@@@.@@..@@@@.@@.@..@..@@@.@.@@@@.@.......@@.@.@..@.@.@@@.@.
....@.@@@@@@@@@@.@@@.@..@@@.@@@@@.@@@@@..@@@@..@@@.@.@.@..@@.@@.@.@@@@@@.@.....@.@@@..@@@@@@@@..@@@@.@.@@@@@@..@@..@@@.@@.@@.@@@@.@.@@@@@@.
@@...@@.@.@@.@@@@@@@.@@@.@.@@..@.@@@@@.@.@...@@..@@@.@..@@@.@@@@@@@@@.@@@.@@@@@.@.@@@@@@.@.@@.@@@.@.@@@@..@@..@.@@@..@@@.@.@@@..@.@.@@@.@@@
@..@@@.@@@@@.@@.@@@@@@@@@@@.@@@..@@@@@@@@@.@@.@.@@@@..@@..@@.@.@@@@.@.@@@.@@@.@@.@@@...@@@@@...@...@@@@@..@@...@@@.@@@@@@@@..@@.@@.@@@@@@@@
.@.@.@@@..@@@.@@@.@@@@@@@@..@@@@@..@@@@@.@@@@@..@..@.@.@.@@@@@@@@@@@@@.@..@@@@@@@@@@.@.@.@@@@.@.@@@@@@@.@@@@@...@@...@@@@@@@@.@@.@@@@@@@@@@
@@@@.@@@@.@@@@@.@..@@.@@@@@...@@...@.@..@..@.@.@.@@..@..@@@@.@@@@@.@..@@@@@@@@@@@.@@.@@@.@@@@.@@...@@@@@@@@..@@.@.@@.@@@.@..@@@@@@@@@@....@
..@.@.@.@@....@@@@.@@@@@@@@.@@@@@.@@@@.@..@@@.@.@.@@.@@@@...@@@@..@.@...@@@@@@@@..@@@@@...@@...@.@..@@@@@.@@@@.@..@@.@@@@@@...@@.@@@.....@@
@@@@@@.@@.@@@..@.@@@@@....@.@@@@@.@..@.@@@@@@..@@.@...@@..@@@@@@.@.@@.@.@.@@...@...@@@..@@@@@@.@.@@@@@..@@@.@.@@@@@@@..@@.@@@@.@.@.@.@.@..@
@@@@@..@@.@@@..@@@....@@..@@@.@@...@.@@.@@@@..@@@@@@..@@@@@@@..@..@.@@.@.@..@@@@@@@...@.@@@.@@@@@@@@@@@@.@...@@.@.....@@@@.@.@@@@@@.@@@@@.@
.@.@@@..@.@.@@.@.@..@@@@@@.@.@@@@@.@@@.@@@@@@@@.@.@.@.@@@@..@..@@@@@@.@...@.@@@@....@.@@@@@@.@..@@@.@@.@..@.@.@.@..@@@.@@@.@..@...@@@.@@@@@
@@.@@@@@@@...@@.@.@@@.@@@@.@.@...@.@@@...@.@@@.@.@@..@@@@@.@@@@@@@@.@.@@..@.@...@@@@@...@@.@.@.@@@@...@@.@.@.@.@@@@@.@..@@..@.@..@@@..@..@@
@@@@@@@@..@.@@@.@.@...@...@@..@@.@@@...@....@@@.@@@.@.@.@..@.@@@@.@@.@@@.@.@@.@@@@@@...@.@.@@@.@.@@@@@.@@@@@..@@@@..@..@@@@@..@...@@@@@@.@@
.@@..@.@..@.@@.@@@@.@@@@.@@@@@.@.@@@@@.@@@...@.@@@.@@@....@..@@.@.@@@...@@@.@@...@.@@...@@..@..@@@.@@.@@@@@@@@..@.@@@@.@@@@@@..@@@.@@.@@@.@
@@@.@@@@@..@.@@@.@@@....@.@...@.@..@@@.@@.@@@@@@.@.@..@@@@.@@.@.....@..@@.@.@@@@..@@@@@@@@..@@.@@.@.@@@@@.@..@@@@.@@.@@@@.@.@@@@@.@@.....@@
@@@.@@@.@@@.@@@@@.@@..@@@@@.@.@@@@@@@.@.@.@@@@@@@@@@@@@.@@.@..@.@@.@@@@.@@@@.@@@@@@@..@@....@@.@.@@@@....@....@@.@@...@.@@@@.@.@@@@.@@@@@@@
@@@.....@@@@.@@@..@.@@.@.@@@@...@@@@@@@.@@@@@@@.@@.@@..@@@@@@@...@@@..@@@@..@..@@@.@@@.@.@@@@@.@@.@@.@..@....@.@@@.@@@@@.@@.@@...@@@.@.@..@
@@.@@.@@@....@.@@.@@.@@@@@@@@@@@@@..@..@..@@.@.@.@..@@.@@@@.@@.@@.@..@.@......@@.@..@@@.@@@.@@@.@@@@....@.@@@@.@@@@@@@..@@.@@@..@.@@..@...@
@@.@@.@@@@@..@..@...@@@.@.@.@@.@...@.@.@@@@@@@.@@.@..@.@...@..@@@@@.@@@@@@.@@.@.@@@.@@.@@@@@.@@@@.@.@.@@@@@@@@@.@.@@@@.@@@.@.@@.@@@.@.@@@@@
.@@@@.@@...@@@.@@.@@@@@.@@..@@.@.@@..@.@.@@@.@.@@@.@@.@.@.@..@@@.@.@@@@@@@..@@.@@.@@.....@@..@.@.@@@..@.@@@.@.@...@@@@@@@.@.@@@@.@@@@.@.@..
.@..@@@@.@@.@.@@@..@@@.@@@@@@@@@@@.@@..@@..@@@@@.@.@.@.@..@.@.@.@@@@@@@@@@@@.@@@..@.@...@.@@@.@..@@@@@@.@@@.@@@...@@@.@@@..@.@@.@@.@.@@.@@.
@@@@@@@.@.@.@@@@@.@..@@@@@@@...@@@@@@@.@@.@@@@@..@@@.@@@.@.@@.@@..@@@@@@@@@@@.@..@@@@..@@@@@.@@@@@@...@@@.@@.@.@.@@@@....@@.@@...@@.@.@@@@@
@@@.@@@@@@....@@..@@.@@@@@..@@@.@..@@.@@@@.@@.@@@@@@@@.@.@@.@@@.@@@@@...@@@@@@.@.@.@@.@@@@@.@..@@..@@.@@@@.@@@@@.@@@@@@@..@.@@....@@.@@.@@@
@@@@@@@.@@@.@@@@@@@..@@..@.@@@@.@@...@@..@@@@@.@@..@@@.@.@@@..@.@@@@@@.@@@@@.@.@.@@@..@@.@@.@@@...@@...@@.@@@@@..@@@.@..@@....@@@..@@@@.@..
.@@..@.@.@@..@..@@@.@@...@@...@@.@.@@@@@@.@.@@.@@@@@@@@.@@.@@@@..@..@.@..@@@..@@@@....@.@.@@@@@..@.@@@@@@@@@.@@.@.@@.@@.@@@.@@@.@@@@.@@@@@@
@@@......@@@.....@@@..@.@@@...@.@@@@@@@.@.@@@@@.@.@@@@@..@.@@@.@@.@@@@@@@@@.@.@@@.@@@.@.@@@@..@@@@..@@@@.@.@..@...@@...@..@@@.@....@@.@@.@.
@@@.@@@@@@@@@@@....@..@@@.@...@@@@@@@.@@@@.@.@@..@@...@@@@@.@@@@@...@..@.@.@@@..@@@@@.@.@.@.@@@.@@@..@.@@@@@@.@@@@@@.@@@@@@@@@@.@@.@..@@@@.
.@@@.@.@.@.@@@@@....@.@@..@@@@..@.@@@@@@.@.@@@@@.@@@..@@@.@.@@@.@@..@@..@.@.@@@@.@@@@.@.@..@..@.@@@.@.@@@@@.@.@@@.@@..@@@@@@@.@@@@..@@@@..@
@@.@@@..@.@.@.@@@@.@@@@@.@@...@.@@@@@@..@@@@.@.@@@@.@@@@@@@@@.@.@@...@.@@@..@.@.@@@@@@@.@.@@.@@@.@@.@@...@...@.@@@..@.@.@..@.@@@@@@@@.@@@@.
@@@@@@@@.@..@@@@@@@.@.@@@@@@..@.@@@@@@@..@..@@@@@@@@@@@@@@@@@@.@@@@@@@.@@@@@@@@@@.@@@@@@@.@.@@@.@.@@@@@..@.@@@@@...@@.@@@@..@@@@..@@@.@@@@.
.@@@@@.@@@@@.@.@@@@@@@..@@@@@@@@@.@@@@.@@.@...@@.@@@@@@.@@@@.@@@@@@.@@@@@@...@@@..@@@@..@.@.@.@@@@@@@@@@.@.@@@@@@@@@..@@.@@@@.@...@@@@@.@.@
@@@@.@@@.@@@@@@...@@..@.@...@@@.@@.@.@.@....@@@...@@....@@....@.@@@@@@@...@...@@@@@@@@@@@@@@@@@...@@@@@@@@@.@.@@@.@@@@@@@@@@@@@@.@@@@@@@.@.
@@@@@@.@@@.@@@..@@@.@.@.@@.@@.@..@@@.@@..@@.@@@@.@.@.@@@@@.@.@@........@@.@@.@@.@@..@.@@.@.@..@@@.@@....@@@@.@.@@@..@..@.@@..@@@.@@@.@.@@@.
..@@.@@@@@@.@@@..@@@.@.@@@@.@.@@.@@@.@.@@@@.@.@.@.@@.@..@@@@@......@.@@@@.@@@.@@.@@@@@@.@@@@.@@...@@.@.@@.@@.@.@@.@@.@@.@@.@@@@@@@.@@@@@.@@
@..@...@.@@@@@@@@...@@@@@@..@@....@..@@@@.@.@.@@@@@@@..@..@@@@.@@.....@..@.@..@@.@..@@@..@.@@@@@.@@@..@@@@@@@@.@@@@@@.....@@.@@.@@.@@..@..@
@@@@.@.@@@..@.@@@..@@@@@@@@.@@....@..@@..@@.@.@.@@.@@.@@@@.@.@.@@..@@.@..@..@@@..@@...@.@@@@@@@.@@.@@@@.@@@@.@@@..@..@.@@.@@@@@.@@.@@@...@@
.@@@.@@.@.@..@.@@..@....@@@@@@.@@.@@.@.@@.@.@@@..@@.@..@.@..@@@@@..@@..@@@.@..@@@...@.@@@@@..@.@..@@...@@.@@..@.@@@@@...@@.@.@.@@.@@@@@@@@@
@.@@@@@.@@..@@.@.@@@@@@@.@@.@@@@@@@@@@...@@@@.@..@.@@@..@.@@@@@@@.@@.@@...@.@@@@..@@@@.@@.@@.@@@@@.@.@.@.....@@.@@..@@@@@@@@..@.@.@@@@.@@@.
@@.@@@@.@@@.@@@.@@.@@@@@@@..@@..@.@..@...@@@.@@@@@@@@@@@@.@@.@@.@@..@@@.@@@.@...@@.@@@@@@@@.@.@@@...@@..@.@.@@@@@@.@@@...@@@..@.@..@.@@.@@@
.@@.@@@@@@@@@...@@.@@@@@@@@..@...@.@@@.@@.@@@@@@@@@.@@@@@@@@@@@@.@@@@@.@..@.@.@@@...@@.@.@@....@@..@@@@@@.@@@.@@@.@@@..@@@@@@.@@.@.@@..@.@@
@.@..@@..@@@.@..@@@.@@.@..@@..@...@@.@.@@@.@@@....@.@@@@@@.@.@.@.@.@@@.@@.@@@@@@..@.@@@@@.@@@@@.@.@@@.@@@@@..@.@.@.@@@@@.@@@@@@@@@@@.@@..@@
.@@@..@@@@@@@@@@@@@.@..@@.@.@@@@@@@@@.@.@@.@@@@@@@@@@.@@@@..@@@.@@@@@.@@@@@..@.@@...@@@@@@@....@@.@@@@@.@@@@.@@@@..@@@@@@@.@.....@.@@@.@@..
@@@@@@@@@.@@@@..@@@@.....@.@@@@@.@.@@@@@@.@@@.@..@@@...@@@@@@@@@@@.@@@...@@@@.@@@@@@.@@..@@.@...@@@@@@@..@@@@@.@.@@@@@@@@@.@..@@@.@@@@@@@..
@@@...@@.@@...@@@.@@.@@@@@@.@@@.@@....@.@.@@@..@.@@@.@.@@..@@@.@@.@@@@.@@@.@.@.@@@..@@@..@@@@@@@@@..@@@.@.@..@.@@.@@@...@.@@@@@.@@..@@@@@.@
@@.@@...@@@.@@@.@@.@.@@@@@.@@@@@.@..@@@@.@@.@@@@@.@@.@@@@@@@.@.@@@..@@@@@@...@@@@@.@.@@@.@....@@@@@@@@@@@@@.@@.@..@@@@@@@@@@@@.@@@.@.@.@@.@
@.@.@@@.@.@.@@@@@@@@@@.@@.@@@@....@..@@..@@@.@.@.@.@.@.@@@@..@@.@@@@@..@@@.@@@.@@@@@@@@@@.@@@@@@@@...@@@@@@@@@.@@@.@@.@@.@...@@@.@@@@.@...@
..@@@@@@...@.@@@@@@@@...@...@@@.@@.@..@.@.@@@.@.@@..@@@.@.@.@.@@@@@@@@@@@.@@@@@@@.@.@@@@.@..@@@.@..@.@@..@...@@..@@@..@@..@.@@@@.@.@@..@@@@
@@.@@@@@@@.@@.@..@@@@..@@@@@@@@@@@@@...@@@...@@.@@@@@@@@@@@@@.@@@.@..@..@.@@@@@@.@@@@@.@.@@@@@@@.@.@@@@.@.@..@@@@.@@.@@.@@@@.@.@.@@@@@..@.@
@@@@@@.@.@...@.@@@@@@...@@@@@@@@.@@@@@@..@@@..@@@@@.@@@@@.@@@.@@.@@@@@.@@.@@@@@@@@@@..@..@@@@@@.@@@@.@...@@.@@@.@@.@...@@@@@@.@@@.@.@..@.@@
.@@@@@...@.@...@@.@.@..@.@...@@@.@@@@@@@..@@@@@@..@.@@@@@@@@@..@@@@@@@@@@@..@@@@@@@@.@.@@@@..@@@@@@@...@..@@.@.@.@.@..@.@@@@@@@@..@@@@@@..@
@@@@@@....@..@@.@@..@@@@.@@@@@@@.@@.@@..@@@@@@@.@.@@.@@.....@.@@@@@@..@.@@..@..@..@@@@@.@@.@@@@@@.@@@.@@@.@.@@@.@@@.@@.@@@@.@...@@@@@..@.@.
@@@..@.@.@@@.@@@@@@.@.@@@@@@..@@.@@.@@@@....@@@.@@@.@.@.@@@@@..@@@.@@@@..@@.@.....@@..@.@@@.@.@@@.@@@@@@.@@..@@.@..@@.@@@@@@@.@@@...@@@@@@@
...@@@@@@@@.....@.@@.@..@@..@@.@.@.@.@@..@@@@@@@@@...@@@@@@..@@..@@@.@@@@@@@....@.@@.@@@@@@.@@@@@.@@@@@@@@@@@@@.@.@@@@@@..@.@@@@@@..@@@@@@.
@@@@.@@@@@.@@@..@@.@@@@@.@@@.@@@...@@@.@.@.@@.@@@@.@.@@@@.@@@@..@.@@.@...@@@@@@@@@.@@@@...@.@.@@@.@@@..@@.@..@.@.@@..@@.....@@@@.@.@@.@@.@@
..@@......@@.@@@.@@..@@@@@..@@..@@.@@@@@@@@@@.@.@@@.@@@@....@@@@..@..@@..@@@...@@.@.@@@@...@@@@@@@...@@@@.@.@.@@@...@@@.@@@@@.@@@.@@....@.@
@.@@.@@..@@@@@@.@.@.@.@@@@@@..@..@@.@@.@@..@.@.@.@..@..@.@@@@..@@@@.@@@@@.@@.@.@@@.@@.@@.@..@@...@@.@.@@@.@@@@.@@@@.@@@@..@.@...@@@@@@@@@@.
.@@..@@.@@@.@..@@@@....@@@..@..@@@.@@@@@@@@@.@@@.@@@@@@..@@@@@@@@@..@@@..@.@@.@@@@....@@@@@..@@.@@@..@@@.@@@@.@.@.@@@@@@@..@..@@@@...@@@@@@
@.@@@@.@@@@@.@.@.@@.@@@.@@.@.@.@@..@.@..@@@@@.@@..@@.@@@@@@.@..@@@...@.@..@..@@@@...@@@@.@@@@@@@..@..@@@.@@.@@@@.@..@@..@@@@@..@.@@@@@@.@.@
@@@@@@@.@@@@..@@@@@@@@.@@@@@@@@@@@@@@@@.@.@..@@...@@.@@.@@@.@@@@..@.@@@@.@.@.@@@@@....@.@@@..@@@@..@@@@.@@@@@@@@...@@..@.@.@@@@@@@@@@...@.@
@@@@@.@.@@@..@@@@..@..@@...@@@.@@.@@@.@@.@@@.@.@@@@@..@..@.@...@@@@@.@@@@@@@@@.@.@@@@@@.@@.....@@@..@@@.@@@@@.@.@@@.@..@.@.@.@@@@.@@@..@@@@
.@@@@@@@.@@.@@@@@@.@@...@@@@.@@@@.@@.@@@@.@.@....@.@.@@@@@@.@..@.@@@@@@@@@...@@.@.@......@.@@..@...@@@@@@.@.@@@@..@@@.@.@@@....@@@.@.@@@@@.
..@@@@@@@@.@@.@@.@.@.@@@@..@..@@.@...@@@.@@@@@@.@..@..@@.......@@.@@@@@@@@@@@.@....@...@..@.@@@....@.@.@.@.@@@@@.@.@@@@@.@@@@@@@@...@@@@.@.
@.@@@.@.@@.@@..@@@...@@.@@.@...@@@...@@@@@..@.@@..@...@@@.@@@@@.@@@@@@@.@@@@.@@@.@@@.@.@@@..@@@@@.....@@@@@@@..@@@.@.@@.@.@..@...@@@@@@@@.@
@@@..@.@@@.@.@@..@@@@...@@.@.@@@.@@@@...@@..@@@@@@.@..@...@@@@..@@..@@@@@......@.@@@@@@@.@@@@.@@@.@@@.@@@@@@@@@@@.@.@@@@...@.@@..@@@@@@@@@@
@@@@@@@@@@@.@@@@@@@@@@@@@@.@.@..@@.@@@@.@.@.@@@..@@@@@.@@@@.@@@...@@@.@..@@@..@.@@@@@.@@..@@.@@@@@...@@@@.@..@..@.@.@@@@@@@@.@@@.@.@@@@@..@
@.@.@@@@@.@.@@@.@@@...@.@.@.@.@@@.@.@@.@@@...@@@@@..@.@@@@.@@@@@.@.@.@@@..@.@.@@.@.@.@@@@..@.@.@@@@@@@.@@@..@@@.@@.@..@@@.@.@@@@@@@.@..@@.@
..@...@@@@@.@..@@@..@.@@@@@.@.@@.@.@@@@.@.@.....@@.@@@.@@@@@@@@..@@@..@.@..@.@@@@@@..@@.@@..@..@@@..@@@.@..@@...@@.@.@@@@@.@.@@@@.@.@@@@@.@
.@@@@@@..@@@@..@@@..@@@@@@.@@@@.@.@@@@..@@@@@.@@@@...@@.@@@...@@@@..@@.@..@@@@@..@...@@@@@..@@@.@@@@@@.@@@@@@@@..@@.@@@@.@.@..@@.@.@@@.@@.@
.@.@@.@@@@.@.@@@..@@.@.@@..@.@@@@...@@...@.@@@@@.@@.@.@@.@.@...@..@..@@..@...@....@.@@..@@@@.@.@.@.@@@@@@..@@.@@@@@@@.@@.@.@.@@.@@@..@..@.@
...@.@@@@..@@@@.@...@..@.@@@.@@@@.@@@@@@@.@@@@@@@@@@@@.@@@.@@.@@.@@@.@@..@..@.@@@@@.@@@@@@@@@.@@@@.@@@@@@@.@@@@@@..@@@@@@@.@..@@.@...@@@@@@
